###                B#########
#   ### ###############   # #
# ####                # # # #
# ################### # # # #
#      #              # # # #
##################### # # # #
#   ##                # # # #
# # ## ### ############ # # #
# #    #                # # #
# # ## ################ # # #
### ##             #### # # #
### ############## ## # # # #
###             ##    # # # #
###### ######## ####### # # #
###### ####             #   #
A      ######################
